......................
......................
......................
..............#.......
....#..#...####..#....
......................
........#....#........
......#.#.............
.......#...#..........
.......#..#..#.#......
....#....#.#..........
.....#...#...##.#.....
........#.............
......................
......................
......................
