......................
......................
......................
............#.........
........##...#.#......
......#.....#..#......
.....#..##.##.#.......
.......##.#....#......
...........#....#.....
..............#.......
....#......#...#......
.....#.....##.........
...............#......
...............#......
......................
......................
