......................
......................
......................
......................
......#...#..###......
......#...#...#.......
......#...#...#.......
......#####...#.......
......#...#...#.......
......#...#...#.......
......#...#...#.......
......#...#..###......
......................
......................
......................
......................
