......................
......................
..........#....#......
........#.....#.......
..#.........#......#..
......................
......#...............
....##.........#......
......#.#.............
.....##.##..#.........
........#.#...........
........#...#.....#...
..#...........#.......
....#.....#.#.........
......................
......................
